Book Link	BOOK TITLE	AUTHOR	PDF file
SIZE
Download Affectionate Guidance
by Srila B.S. Govinda Maharaj [PDF, 1.2 MB]	Affectionate Guidance	Srila B.S. Govinda Maharaj	1.2 MB
Download Archchan-kana
by Srila B.S. Govinda Maharaj [PDF, 87 KB]	Archchan-kana	SCSMath	87 KB
Download Benedictine Tree of Divine Aspiration
by Srila B.S. Govinda Maharaj [PDF, 421 KB]	Benedictine Tree of Divine Aspiration	Srila B.S. Govinda Maharaj	421 KB
Download Bhagavat Darshan 
by Srila B.S. Govinda Maharaj [PDF, 11.1 MB]	Bhagavat Darshan - scans	Srila B.S. Govinda Maharaj	11.1 MB
Download Brahma-samhita - Quintessence of Reality the Beautiful [PDF, 5.2 MB]	Brahma-samhita - Quintessence of Reality the Beautiful (scans)	SCSMath	5.2 MB
Download Catalog - All SCSMath books and addresses - May 2007 [PDF, 13.5 MB]	Catalog - All SCSMath books and addresses - May 2007	SCSMath	13.5 MB
Download Catalogue 2003 - SCSMath Publications [PDF, 2.3 MB]	Catalogue 2003 - SCSMath Publications	SCSMath	2.3 MB
Download Catalogue 2007 - SCSMath Publications [PDF, 14.2 MB]	Catalogue 2007 - SCSMath Publications	SCSMath	14.2 MB
Download Centenary Anthology by Srila B.S. Govinda Maharaj [PDF, 1 MB]	Centenary Anthology	Srila B.S. Govinda Maharaj	1,005 KB
Download Centenary Anthology by Srila B.S. Govinda Maharaj [PDF, 1 MB]	Chaitanya Mahaprabhu - His Life And Precepts	Srila Bhakti Vinod Thakur	7.1 MB
Download Chaitanya Saraswati No.1 Voice of Sri Chaitanyadev  [PDF, 16.6 MB]	Chaitanya Saraswati No.1
Voice of Sri Chaitanyadev - scans	SCSMath	16.6 MB
Download Chaitanya Saraswati No.2 - 1994  [PDF, 11.1 MB]	Chaitanya Saraswati No.2 - 1994 - scans	SCSMath	11.1 MB
Download Dignity of the Divine Servitor by Srila B.S. Govinda Maharaj [PDF, 15.7 MB]	Dignity of the Divine Servitor - scans	Srila B.S. Govinda Maharaj	15.7 MB
Download Divine Aspiration - 2006 by Srila B.R. Sridhar Maharaj [PDF, 5.1 MB]	Divine Aspiration - 2006	Srila B.R. Sridhar Maharaj	5.1 MB
Download Divine Guidance - 2004 by Srila B.S. Govinda Maharaj [PDF, 890 KB]	Divine Guidance - 2004	Srila B.S. Govinda Maharaj	890 KB
Download Divine Message for the Devotees - 1993 by Srila B.S. Govinda Maharaj [PDF, 3.2 MB]	Divine Message for the Devotees - 1993 - scans	Srila B.S. Govinda Maharaj	3.2 MB
Download Exclusive Guardianship by Srila B.R. Sridhar Maharaj [PDF, 579 KB]	Exclusive Guardianship	Srila B.R. Sridhar Maharaj	579 KB
Download Gita - Hidden Treasure of the Sweet Absolute 2ndEdition by Srila B.R. Sridhar Maharaj [PDF, 1.9 MB]	Gita - Hidden Treasure of the Sweet Absolute
- 2ndEdition	Srila B.R. Sridhar Maharaj	1.9 MB
Download Golden Reflections by Srila B.S. Govinda Maharaj [PDF, 74.3 MB]	Golden Reflections - scans	Srila B.S. Govinda Maharaj	74.3 MB
Download Golden Staircase - 1994 by Srila B.R. Sridhar Maharaj [PDF, 982 MB]	Golden Staircase - 1994	Srila B.R. Sridhar Maharaj	982 KB
Download Golden Volcano - 2006 by Srila B.R. Sridhar Maharaj [PDF, 2.8 MB]	Golden Volcano - 2006	Srila B.R. Sridhar Maharaj	2.8 MB
Download Guardian of Devotion - Kolkata Edition - 1986 - BlueCover by Srila B.R. Sridhar Maharaj [PDF, 12 MB]	Guardian of Devotion
- Kolkata Edition - 1986 - BlueCover	Srila B.R. Sridhar Maharaj	12 MB
Download Guardian of Devotion -San Jose Edition - BrownCover - by Srila B.R. Sridhar Maharaj [PDF, 16.8 MB]	Guardian of Devotion
-San Jose Edition - BrownCover	Srila B.R. Sridhar Maharaj	16.8 MB
Download Haridasa Thakura (Booklet translated by B.V. Bharati Maharaj - 1986 by Srila B.S. Saraswati Thakur [PDF, 8.8 MB]	Haridasa Thakura
(Booklet translated by B.V. Bharati Maharaj - 1986 - scans)	Srila B.S. Saraswati Thakur	8.8 MB
Download Heart and Halo by Srila B.R. Sridhar Maharaj [PDF, 351 KB]	Heart and Halo	Srila B.R. Sridhar Maharaj	351 KB
Download Holy Engagement by Srila B.R. Sridhar Maharaj [PDF, 1.1 MB]	Holy Engagement	Srila B.R. Sridhar Maharaj	1.1 MB
Download Holy Name - Glories and Offences to Avoid 6th Edition [PDF, 823 KB]	Holy Name - Glories and Offences to Avoid
6th Edition	SCSMath	823 KB
Download Home Comfort 6th Indian Edition by Srila B.R. Sridhar Maharaj [PDF, 313 KB]	Home Comfort
6th Indian Edition	Srila B.R. Sridhar Maharaj	313 KB
Download Inner Fulfilment - 2004 by Srila B.R. Sridhar Maharaj [PDF, 556 KB]	Inner Fulfilment - 2004	Srila B.R. Sridhar Maharaj	556 KB
Kirtan Guide - Pocket Edition - English - 2013 [PDF, 1.8 MB]	Kirtan Guide - Pocket Edition - English - 2013	SCSMath	1.8 MB
Kirttan Guide 10th Edition [PDF, 3.7 MB]	Kirttan Guide 10th Edition *Updated August 2023. (Now with interactive Index and Contents, and click top right corner of any page to go to the Index.)	SCSMath	9.5 MB
Land of Nectar - Colouring Book - 2007 [PDF, 17.2 MB]	Land of Nectar - Colouring Book - 2007	SCSMath	17.2 MB
Loving Search for the Lost Servant - 2001 by Srila B.R. Sridhar Maharaj [PDF, 1 MB]	Loving Search for the Lost Servant	Srila B.R. Sridhar Maharaj	80MB
Download Hidden Treasure of the Holy Dhama Nabadwipa (Nabadwip Dham Mahatmya and Nabadwip Bhavataranga by Srila Bhakti Vinod Thakur [PDF, 25.1 KB]	Nabadwip Dham Mahatmya
and Nabadwip Bhavataranga
(With Bengali verses, and word by word translations)	Srila Bhakti Vinod Thakur	5 MB
Download Hidden Treasure of the Holy Dhama Nabadwipa (Nabadwip Dham Mahatmya and Nabadwip Bhavataranga by Srila Bhakti Vinod Thakur [PDF, 25.1 KB]	Nabadwip Dham Mahatmya
and Nabadwip Bhavataranga
(Hidden Treasure of the Holy Dhama Nabadwipa scans)	Srila Bhakti Vinod Thakur	25.1 MB
Nectarean Glories of Sri Nityananda Prabhu by Srila B.S. Govinda Maharaj [PDF, 1.4 MB]	Nectarean Glories of Sri Nityananda Prabhu - 120209	Srila B.S. Govinda Maharaj	1.4 MB
Ocean of Nectar - 2004 by Srila B.R. Sridhar Maharaj [PDF, 1.3 MB]	Ocean of Nectar - 2004	Srila B.R. Sridhar Maharaj	1.3 MB
Original Source - 2nd Edition - 2001 by Srila B.R. Sridhar Maharaj [PDF, 122 KB]	Original Source - 2nd Edition - 2001	Srila B.S. Govinda Maharaj	122 KB
Prapanna-Jivanamritam by Srila B.R. Sridhar Maharaj [PDF, 8.8 MB]	Prapanna-Jivanamritam	Srila B.R. Sridhar Maharaj	8.8 MB
Premadhama-deva-stotram by Srila B.R. Sridhar Maharaj [PDF, 247 KB]	Premadhama-deva-stotram	Srila B.R. Sridhar Maharaj	247 KB
Religion of the Heart - 2nd Edition by Srila B.S. Govinda Maharaj [PDF, 3.7 MB]	Religion of the Heart - 2nd Edition	Srila B.S. Govinda Maharaj	3.7 MB
Revealed Truth - Updated web edition by Srila B.S. Govinda Maharaj [PDF, 29.7 MB]	Revealed Truth - Updated web edition - 130706	Srila B.S. Govinda Maharaj	29.7 MB
Saranagati - Updated web edition by Srila Bhakti Vinod Thakur [PDF, 3.6 MB]	Saranagati - Updated web edition - 120802	Srila Bhakti Vinod Thakur	3.6 MB
Saraswat Style Manual 1.0.2 (1st formal release) [PDF, 9.1 MB]	Saraswat Style Manual 1.0.2
(1st formal release)	SCSMath	9.1 MB
Search for Sri Krishna - Reality the Beautiful by Srila B.R. Sridhar Maharaj [PDF, 823 KB]	Search for Sri Krishna - Reality the Beautiful	Srila B.R. Sridhar Maharaj	823 KB
Sermons of the Guardian of Devotion Volume 1 by Srila B.R. Sridhar Maharaj [PDF, 25.1 MB]	Sermons of the Guardian of Devotion
- Volume 1 (scans)	Srila B.R. Sridhar Maharaj	25.1 MB
Sermons of the Guardian of Devotion Volume 2 by Srila B.R. Sridhar Maharaj [PDF, 31.4 MB]	Sermons of the Guardian of Devotion
- Volume 2 (scans)	Srila B.R. Sridhar Maharaj	31.4 MB
Sermons of the Guardian of Devotion Volume 3 1999 by Srila B.R. Sridhar Maharaj [PDF, 5.5 MB]	Sermons of the Guardian of Devotion
- Volume 3 - 1999	Srila B.R. Sridhar Maharaj	5.5 MB
Sermons of the Guardian of Devotion Volume 4 by Srila B.R. Sridhar Maharaj [PDF, 9.9 MB]	Sermons of the Guardian of Devotion
- Volume 4 (scans)	Srila B.R. Sridhar Maharaj	9.9 MB
Service Life [PDF, 35.3 MB]	Service Life	SCSMath	35.3 MB
Spiritual Assistance for our Friends [PDF, 329 KB]	Spiritual Assistance for our Friends	SCSMath	329 KB
Sri Guru And His Grace - 4th Printing - 1999 by Srila B.R. Sridhar Maharaj [PDF, 1.1 MB]	Sri Guru And His Grace - 4th Printing - 1999	Srila B.R. Sridhar Maharaj	1.1 MB
Subjective Evolution of Consciousness - 1998 by Srila B.R. Sridhar Maharaj [PDF, 620 KB]	Subjective Evolution of Consciousness - 1998	Srila B.R. Sridhar Maharaj	620 KB
The Bhagavata (colour) by Srila Bhakti Vinod Thakur [PDF, 23.9 MB]	The Bhagavata (colour)	Srila Bhakti Vinod Thakur	23.9 MB

What's New? | Useful Downloads | Centres

This website is Â© Sri Chaitanya Saraswat Math, Nabadwip.
Founder-Acharya: Srila B. R. Sridhar Maharaj
President-Acharya: Srila B. S. Govinda Maharaj
www.scsmath.com - online since 1995. Updated regularly.


 